110000000000000
010111111111110
010101010100010
010101010111010
010100000101000
011101111101110
000100000001000
011101011111100
000111001010110
000000000000010
011111111111110
010100001000010
010111100000000
010000111111111
000000000000000